C 35,19,73
F 15,6,40

NO txt/north.xpm
EA txt/east.xpm
SO txt/south.xpm
WE txt/west.xpm


111111111111111111111111111111111111
111111111111000000000001111111111111
111111100000000000000000011111111111
111100000000000000000000000011111111
111000000000000S00000000000000011111
100000000000000000000000000000000001
100000000000000000000000000000000011
100000000000000000000000000000000001
111111111111110001111111111111111111
             10001               
             10001            
             10001 
111111111111111011111111111111111111
100000000000000000000000000000000001
100000000000000000000000000000000001
100000000000000000000000000000000001
100000000000000000000000000000000001
100000000000000000000000000000000001
100000000000000000000000000000000001
111111111111111111111111111111111111