NO txt/north.xpm
EA txt/east.xpm
SO txt/south.xpm
WE txt/west.xpm

C 35,19,73
F 15,6,40

11111
10001
10S01
10001
10001
10001
10001
10001
10001
10001
10001
10001
10001
10001
10001
10001
10001
10001
10001
10001
10001
10001
10001
10001
10001
10001
10001
10001
10001
10001
10001
10001
10001
10001
10001
10001
10001
10001
10001
10001
10001
10001
10001
10001
10001
10001
10001
10001
10001
10001
10001
10001
10001
10001
10001
10001
10001
10001
10001
10001
10001
10001
10001
10001
10001
10001
10001
10001
10001
10001
10001
10001
10001
10001
10001
10001
10001
10001
10001
10001
10001
10001
10001
10001
10001
10001
10001
10001
10001
10001
10001
10001
10001
10001
10001
10001
10001
10001
10001
10001
10001
10001
10001
10001
10001
10001
10001
10001
10001
10001
10001
10001
10001
1000110001
1000110001
1000110001
1000110001
1000110001
1000110001
1000110001
1000110001
1000110001
1000110001
1000110001
1000110001
1000110001
1000110001
1000110001
1000110001
1000110001
1000110001
1000110001
1000110001
1000110001
1000110001
1000110001
1000110001
1000110001
1000110001
1000110001
1000110001
1000110001
1000110001
1000110001
1000110001
1000110001
1000110001
1000110001
1000110001
1000110001
1000110001
1000110001
1000110001
1000110001
1000110001
1000110001
1000110001
1000110001
1000110001
1000110001
1000110001
1000110001
1000110001
1000110001
1000110001
1000110001
1000110001
1000110001
1000110001
1000110001
1000110001
1000110001
1000110001
1000110001
1000110001
1000110001
1000110001
1000110001
1000110001
1000110001
1000110001
1000110001
1000110001
1000110001
1000110001
1000110001
1000110001
1000110001
1000110001
1000110001
1000110001
1000110001
1000110001
1000110001
1000110001
1000110001
1000110001
1000110001
1000110001
1000110001
1000110001
1000110001
1000110001
1000110001
1000110001
1000110001
1000110001
1000110001
1000110001
1000110001
1000110001
1000110001
1000110001
1000110001
1000110001
1000110001
1000110001
1000110001
1000110001
1000110001
1000110001
1000110001
10001
11111