NO txt/north.xpm
EA txt/east.xpm
SO txt/south.xpm
WE txt/west.xpm


C 35,19,73
F 90,0,0

1111111111111111111111111111111111111111111111111111
1000000000000000000000000000000000000000000000000001
1000000000000000000000000000000000000000000000000001
1000000000000000000000000000000000000000011000000001
1000000000000000001000000000000000000000011000000001
1000000000000000001000000000000000000000000000000001
1000000000000000000000000S00000000000000000000000001
1000000000000000000000000000000000000000000000000001
1000000000000000000000000000000000000000000000001001
1000000000000000000000000000000000000000000000001001
1000000000000000000000000000000000000000000000001001
1000000000000000000000000000000000000000000000001001
1000000000000000000000000000000000000000000000001001
1000000000000000000000000000000000000000000000001001
1000000000000000000000000000000000000000000000001001
1000000000000000000000000000000000000000000000001001
1000000000000000000000000000000000000000000000001001
1000000000000000000000000000000000000000000000001001
1000000000000000000000000000000000000000000000001001
1000000000000000000000000000000000000000000000001001
1000000000000000000000000000000000000000000000001001
1000000000000000000000000000000000000000000000001001
1000000000000000000000000000000000000000000000001001
1000000000000000000000000000000000000000000000010001
1000011100000000000000000000000000000000000000010001
1000000100000000000000000000000000000000000000000001
1000000000000000001000000000000000000000000000010001
1111111111111111111111111111111111111111111111111111
